@@@@@@@@@@@@@@@@@@@@
@..................@
@@@..............@@@
@..................@
@......######......@
@......#....#......@
@@@....######....@@@
@..................@
@..................@
@....##@....@##....@
@......@####@......@
@..................@
@@@.....###......@@@
@..................@
@....###...###.....@
@.....#.....#......@
@@@...#.....#.....@@
@..................@
@........B.........@
@@@@@@@@@@@@@@@@@@@@